Ä	C,
Å	u"
Ç	e'
É	a^
Ñ	a"
Ö	a`
Ü	a*
á	c,
à	e^
â	e"
ä	e`
ã	i"
å	i^
ç	i`
é	A"
è	A*
ê	E'
ë	a\e
í	í
ì	o^
î	o"
ï	o`
ñ	u^
ó	u`
ò	y"
ô	O"
ö	U"
õ	c|
ú	L-
ù	Y=
û	P\t
ü	f-
†	a'
°	i'
¢	o'
£	u'
§	n~
•	N~
¶	a_
ß	o_
®	-?
